0000000000000000
1000000000000001
1000022200000001
1111000200001111
1000222222220001
1040020000000001
1440020000000001
1400020331144411
1400000330240001
1000000330240001
1011411022220001
1000000000020001
1111222000001111
1000000000000001
1000000000000001
1111111111111111
