11111111111111111
12220001100000011
10000001100000011
10000001100001011
12244001100001311
12224001102201111
13224001102200011
12233223322222211
12222223322224411
14400001100444411
14411111100442211
10000331130000311
12220001111111011
12220001100100011
12220001100100011
11111111111111111
