11111111111111111
10000001000000011
10002221000000011
10002421030300011
10002422033300011
10002442000022211
10002242200022211
11111244201111111
11111224421111111
12222022422000011
10000002442000011
10033302242200011
10030301244200011
10000001222200011
10000001000000011
11111111111111111
