1111111111111111
1010000000100001
1111111111110001
1111111111110001
1222222222211001
1200000000221101
1003003000022241
1003003000022201
1000200000221111
1222222222211111
1222111222111101
1111111111111031
1013111111110031
1310301110113311
1000001010000001
1111111111111111