11111111111111111
10000000022332211
14440000030000311
10000000022332211
12220233320222211
12220200020222211
12220300030222211
11110300030111111
10000200020000011
10000233320000011
10000000044440011
12233220001000011
13000030001011111
12233220001000011
10000000001000011
11111111111111111
